Name	Permeability
2-mercaptobenzothiazole 	Permeable
4-(Isopropylamino)diphenylamine 	Permeable
5-O-phosphono-alpha-D-ribofuranosyl diphosphate 	Permeable
Abacavir 	Permeable
Abametapir 	Permeable
Abarelix 	Non-Permeable
Abemaciclib 	Permeable
Abiraterone 	Permeable
Abrocitinib 	Non-Permeable
Acalabrutinib 	Non-Permeable
Acamprosate 	Non-Permeable
Acarbose 	Non-Permeable
Acebutolol 	Non-Permeable
Aceclidine 	Permeable
Aceclofenac 	Non-Permeable
Acemetacin 	Permeable
Acenocoumarol 	Permeable
Acetaminophen 	Permeable
Acetazolamide 	Permeable
Acetic acid 	Non-Permeable
Acetohexamide 	Permeable
Acetohydroxamic acid 	Permeable
Acetophenazine 	Permeable
Acetyl sulfisoxazole 	Permeable
Acetylcarnitine 	Permeable
Acetylcholine 	Non-Permeable
Acetylcysteine 	Permeable
Acetyldigitoxin 	Non-Permeable
Acetylene 	Permeable
Acetylsalicylic acid 	Non-Permeable
Acipimox 	Permeable
Acitretin 	Permeable
Aclidinium 	Non-Permeable
Acrivastine 	Permeable
Acyclovir 	Permeable
Adagrasib 	Non-Permeable
Adapalene 	Non-Permeable
Adefovir dipivoxil 	Non-Permeable
Ademetionine 	Permeable
Adenine 	Non-Permeable
Adenosine 	Permeable
Adenosine phosphate 	Permeable
Adiphenine 	Permeable
Afamelanotide 	Non-Permeable
Afatinib 	Non-Permeable
Agomelatine 	Permeable
Ajmaline 	Permeable
Alatrofloxacin 	Non-Permeable
Albendazole 	Permeable
Alcaftadine 	Permeable
Alclofenac 	Permeable
Alclometasone 	Permeable
Alcloxa 	Non-Permeable
Alectinib 	Non-Permeable
Alendronic acid 	Non-Permeable
Alfacalcidol 	Permeable
Alfentanil 	Permeable
Alfuzosin 	Permeable
Alimemazine 	Permeable
Aliskiren 	Non-Permeable
Alitretinoin 	Permeable
Allantoin 	Permeable
Alloin 	Non-Permeable
Allopurinol 	Permeable
Almitrine 	Permeable
Almotriptan 	Permeable
Alogliptin 	Permeable
Alosetron 	Permeable
Alpelisib 	Permeable
alpha-Amyl cinnamaldehyde 	Permeable
alpha-Arbutin 	Non-Permeable
alpha-Linolenic acid 	Permeable
alpha-Tocopherol succinate 	Non-Permeable
Alprazolam 	Permeable
Alprostadil 	Non-Permeable
Altretamine 	Permeable
Alvimopan 	Permeable
Amantadine 	Permeable
Ambenonium 	Non-Permeable
Ambrisentan 	Permeable
Ambroxol 	Permeable
Amcinonide 	Permeable
Amifampridine 	Non-Permeable
Amifostine 	Non-Permeable
Amikacin 	Non-Permeable
Amiloride 	Non-Permeable
Amiloxate 	Permeable
Aminobenzoic acid 	Permeable
Aminocaproic acid 	Non-Permeable
Aminoglutethimide 	Permeable
Aminohippuric acid 	Permeable
Aminolevulinic acid 	Permeable
Aminophenazone 	Permeable
Aminophylline 	Non-Permeable
Aminosalicylic acid 	Non-Permeable
Amiodarone 	Non-Permeable
Amisulpride 	Permeable
Amitriptyline 	Permeable
Amitriptylinoxide 	Permeable
Amlexanox 	Non-Permeable
Amlodipine 	Permeable
Ammonia N-13 	Permeable
Ammonium carbonate 	Non-Permeable
Ammonium lactate 	Permeable
Amobarbital 	Permeable
Amodiaquine 	Permeable
Amorolfine 	Permeable
Amoxapine 	Permeable
Amoxicillin 	Non-Permeable
Amphetamine 	Permeable
Amphotericin B 	Non-Permeable
Ampicillin 	Non-Permeable
Amprenavir 	Non-Permeable
Amrinone 	Permeable
Amsacrine 	Non-Permeable
Amyl Nitrite 	Permeable
Amylmetacresol 	Permeable
Amylocaine 	Permeable
Anagrelide 	Permeable
Anastrozole 	Permeable
Anethole 	Permeable
Anethole trithione 	Permeable
Anidulafungin 	Non-Permeable
Anileridine 	Permeable
Anisindione 	Permeable
Anisotropine methylbromide 	Permeable
Antazoline 	Permeable
Anthralin 	Permeable
Antipyrine 	Non-Permeable
Antrafenine 	Permeable
Apalutamide 	Non-Permeable
Apixaban 	Non-Permeable
Apomorphine 	Permeable
Apraclonidine 	Permeable
Apremilast 	Permeable
Aprepitant 	Non-Permeable
Apronalide 	Permeable
Arbutamine 	Non-Permeable
Arbutin 	Non-Permeable
Arformoterol 	Non-Permeable
Argatroban 	Non-Permeable
Aripiprazole 	Permeable
Aripiprazole lauroxil 	Permeable
Armodafinil 	Permeable
Artemether 	Permeable
Artemotil 	Permeable
Artenimol 	Permeable
Artesunate 	Permeable
Articaine 	Permeable
Arzoxifene 	Non-Permeable
Asciminib 	Non-Permeable
Ascorbic acid 	Permeable
Asenapine 	Permeable
Asparagine 	Permeable
Aspartic acid 	Permeable
Astemizole 	Non-Permeable
Asunaprevir 	Non-Permeable
Ataluren 	Permeable
Atazanavir 	Non-Permeable
Atenolol 	Non-Permeable
Atogepant 	Non-Permeable
Atomoxetine 	Permeable
Atorvastatin 	Non-Permeable
Atosiban 	Non-Permeable
Atovaquone 	Non-Permeable
Atracurium besylate 	Non-Permeable
Atropine 	Permeable
Avacopan 	Permeable
Avanafil 	Non-Permeable
Avapritinib 	Permeable
Avatrombopag 	Non-Permeable
Avibactam 	Non-Permeable
Avobenzone 	Non-Permeable
Axitinib 	Permeable
Azacitidine 	Permeable
Azatadine 	Permeable
Azathioprine 	Non-Permeable
Azelaic acid 	Non-Permeable
Azelastine 	Permeable
Azilsartan medoxomil 	Non-Permeable
Azithromycin 	Non-Permeable
Azlocillin 	Non-Permeable
Aztreonam 	Non-Permeable
Bacampicillin 	Non-Permeable
Bacitracin 	Non-Permeable
Baclofen 	Permeable
Baloxavir marboxil 	Permeable
Balsalazide 	Permeable
Baricitinib 	Permeable
Barium sulfate 	Permeable
Bazedoxifene 	Non-Permeable
Beclomethasone dipropionate 	Permeable
Bedaquiline 	Non-Permeable
Belinostat 	Permeable
Belumosudil 	Non-Permeable
Belzutifan 	Permeable
Bemotrizinol 	Non-Permeable
Bempedoic acid 	Permeable
Benazepril 	Permeable
Bendamustine 	Permeable
Bendazac 	Permeable
Bendroflumethiazide 	Permeable
Benfotiamine 	Permeable
Benorilate 	Permeable
Benoxaprofen 	Permeable
Benperidol 	Permeable
Benserazide 	Non-Permeable
Benzatropine 	Permeable
Benzethonium 	Non-Permeable
Benzhydrocodone 	Permeable
Benziodarone 	Permeable
Benznidazole 	Permeable
Benzocaine 	Permeable
Benzoic acid 	Non-Permeable
Benzoin 	Permeable
Benzonatate 	Permeable
Benzoyl peroxide 	Permeable
Benzphetamine 	Permeable
Benzthiazide 	Non-Permeable
Benzydamine 	Permeable
Benzyl alcohol 	Permeable
Benzyl benzoate 	Permeable
Benzylparaben 	Non-Permeable
Benzylpenicillin 	Non-Permeable
Bepotastine 	Non-Permeable
Bepridil 	Non-Permeable
Berberine 	Permeable
Berotralstat 	Non-Permeable
Besifloxacin 	Non-Permeable
Beta carotene 	Permeable
Betahistine 	Permeable
Betaine 	Permeable
Betamethasone 	Permeable
Betamethasone phosphate 	Permeable
Betaxolol 	Permeable
Betazole 	Permeable
Bethanechol 	Non-Permeable
Bethanidine 	Permeable
Betiatide 	Non-Permeable
Betrixaban 	Non-Permeable
Betulinic Acid 	Permeable
Bexarotene 	Permeable
Bezafibrate 	Permeable
Bicalutamide 	Permeable
Bicisate 	Permeable
Bictegravir 	Permeable
Bifonazole 	Permeable
Biguanide 	Permeable
Bilastine 	Permeable
Bimatoprost 	Permeable
Binimetinib 	Non-Permeable
Bioallethrin 	Permeable
Biotin 	Permeable
Biperiden 	Permeable
Bisacodyl 	Permeable
Bismuth subcitrate potassium 	Non-Permeable
Bismuth subnitrate 	Permeable
Bisoctrizole 	Non-Permeable
Bisoprolol 	Permeable
Bisoxatin 	Non-Permeable
Bisphenol A diglycidyl ether 	Permeable
Bithionol 	Permeable
Bleomycin 	Non-Permeable
Boceprevir 	Non-Permeable
Boscalid 	Permeable
Bosentan 	Non-Permeable
Bosutinib 	Permeable
Bretylium 	Non-Permeable
Brexanolone 	Permeable
Brexpiprazole 	Permeable
Brigatinib 	Non-Permeable
Brilliant blue G 	Non-Permeable
Brilliant green cation 	Permeable
Brimonidine 	Permeable
Brincidofovir 	Non-Permeable
Brinzolamide 	Non-Permeable
Brivaracetam 	Permeable
Brivudine 	Permeable
Bromazepam 	Permeable
Bromfenac 	Permeable
Bromhexine 	Permeable
Bromocriptine 	Non-Permeable
Bromodiphenhydramine 	Permeable
Bromothalonil 	Permeable
Bromotheophylline 	Permeable
Bromperidol 	Permeable
Brompheniramine 	Permeable
Bronopol 	Non-Permeable
Bucetin 	Permeable
Buclizine 	Permeable
Budesonide 	Permeable
Bufexamac 	Permeable
Bumadizone 	Permeable
Bumetanide 	Permeable
Bupivacaine 	Permeable
Buprenorphine 	Permeable
Bupropion 	Permeable
Buserelin 	Non-Permeable
Buspirone 	Permeable
Busulfan 	Permeable
Butabarbital 	Permeable
Butacaine 	Permeable
Butalbital 	Permeable
Butamben 	Permeable
Butaperazine 	Permeable
Butenafine 	Permeable
Butobarbital 	Permeable
Butoconazole 	Permeable
Butorphanol 	Permeable
Butylene glycol 	Non-Permeable
Butylparaben 	Permeable
Butylscopolamine 	Non-Permeable
Cabazitaxel 	Non-Permeable
Cabergoline 	Permeable
Cabotegravir 	Non-Permeable
Cabozantinib 	Non-Permeable
Caffeine 	Permeable
Calcifediol 	Permeable
Calcipotriol 	Permeable
Calcitriol 	Permeable
Calcium acetate 	Non-Permeable
Calcium ascorbate 	Non-Permeable
Calcium carbimide 	Permeable
Calcium carbonate 	Non-Permeable
Calcium citrate 	Non-Permeable
Calcium glubionate anhydrous 	Non-Permeable
Calcium glucoheptonate 	Non-Permeable
Calcium gluconate 	Non-Permeable
Calcium glycerophosphate 	Non-Permeable
Calcium lactate 	Non-Permeable
Calcium levulinate 	Permeable
Calcium Phosphate 	Permeable
Calcium phosphate dihydrate 	Non-Permeable
Calcium saccharate 	Non-Permeable
Calcium threonate 	Non-Permeable
Calcium undecylenate 	Permeable
Camphor 	Permeable
Canagliflozin 	Permeable
Candesartan cilexetil 	Non-Permeable
Candicidin 	Non-Permeable
Cangrelor 	Non-Permeable
Cannabidiol 	Permeable
Canrenoic acid 	Permeable
Cantharidin 	Permeable
Capecitabine 	Permeable
Capmatinib 	Permeable
Capreomycin 	Non-Permeable
Capsaicin 	Permeable
Captopril 	Permeable
Carbamazepine 	Permeable
Carbamide peroxide 	Permeable
Carbamoylcholine 	Non-Permeable
Carbenicillin 	Non-Permeable
Carbetocin 	Non-Permeable
Carbidopa 	Non-Permeable
Carbimazole 	Permeable
Carbinoxamine 	Permeable
Carbocisteine 	Non-Permeable
Carbocromen 	Permeable
Carbon dioxide 	Permeable
Carboprost tromethamine 	Permeable
Carboxin 	Permeable
Carfilzomib 	Non-Permeable
Carglumic acid 	Permeable
Carindacillin 	Non-Permeable
Cariprazine 	Permeable
Carisoprodol 	Permeable
Carmustine 	Permeable
Carprofen 	Permeable
Carteolol 	Non-Permeable
Carvedilol 	Permeable
Caspofungin 	Non-Permeable
Cedazuridine 	Non-Permeable
Cefaclor 	Non-Permeable
Cefadroxil 	Non-Permeable
Cefalotin 	Non-Permeable
Cefamandole 	Non-Permeable
Cefamandole nafate 	Non-Permeable
Cefapirin 	Non-Permeable
Cefazolin 	Non-Permeable
Cefdinir 	Non-Permeable
Cefditoren 	Non-Permeable
Cefepime 	Non-Permeable
Cefiderocol 	Non-Permeable
Cefixime 	Non-Permeable
Cefmenoxime 	Non-Permeable
Cefmetazole 	Non-Permeable
Cefonicid 	Non-Permeable
Cefoperazone 	Non-Permeable
Ceforanide 	Non-Permeable
Cefotaxime 	Non-Permeable
Cefotetan 	Non-Permeable
Cefotiam 	Non-Permeable
Cefoxitin 	Non-Permeable
Cefpiramide 	Non-Permeable
Cefpirome 	Non-Permeable
Cefpodoxime 	Non-Permeable
Cefprozil 	Non-Permeable
Cefradine 	Non-Permeable
Ceftaroline fosamil 	Non-Permeable
Ceftazidime 	Non-Permeable
Ceftibuten 	Non-Permeable
Ceftizoxime 	Non-Permeable
Ceftobiprole 	Non-Permeable
Ceftobiprole medocaril 	Non-Permeable
Ceftolozane 	Non-Permeable
Ceftriaxone 	Non-Permeable
Cefuroxime 	Non-Permeable
Celecoxib 	Non-Permeable
Celiprolol 	Non-Permeable
Cenobamate 	Permeable
Cephalexin 	Non-Permeable
Cephaloglycin 	Non-Permeable
Ceritinib 	Non-Permeable
Cerivastatin 	Permeable
Ceruletide 	Non-Permeable
Cetalkonium 	Permeable
Cetirizine 	Non-Permeable
Cetrimonium 	Permeable
Cetrorelix 	Non-Permeable
Cetyl alcohol 	Permeable
Cetylpyridinium 	Permeable
Cevimeline 	Permeable
Chenodeoxycholic acid 	Non-Permeable
Chloral hydrate 	Permeable
Chlorambucil 	Non-Permeable
Chloramphenicol 	Permeable
Chloramphenicol palmitate 	Permeable
Chloramphenicol succinate 	Non-Permeable
Chlorcyclizine 	Permeable
Chlordiazepoxide 	Permeable
Chlorhexidine 	Non-Permeable
Chloric acid 	Non-Permeable
Chlormerodrin 	Permeable
Chlormerodrin Hg-197 	Permeable
Chlormezanone 	Permeable
Chlorobutanol 	Permeable
Chloroform 	Permeable
Chloroprocaine 	Permeable
Chloroquine 	Non-Permeable
Chlorothiazide 	Non-Permeable
Chloroxine 	Permeable
Chloroxylenol 	Permeable
Chlorphenesin 	Permeable
Chlorphenesin carbamate 	Permeable
Chlorpheniramine 	Permeable
Chlorpromazine 	Permeable
Chlorpropamide 	Non-Permeable
Chlorprothixene 	Permeable
Chlorquinaldol 	Permeable
Chlortetracycline 	Non-Permeable
Chlorthalidone 	Non-Permeable
Chlorzoxazone 	Permeable
Cholecalciferol 	Permeable
Cholesterol 	Permeable
Cholic Acid 	Non-Permeable
Choline 	Permeable
Choline C 11 	Non-Permeable
Choline C-11 	Permeable
Choline magnesium trisalicylate 	Non-Permeable
Choline salicylate 	Non-Permeable
Cianidanol 	Non-Permeable
Ciclesonide 	Permeable
Ciclopirox 	Permeable
Cidofovir 	Non-Permeable
Cilastatin 	Non-Permeable
Cilazapril 	Permeable
Cilostazol 	Permeable
Cimetidine 	Non-Permeable
Cinacalcet 	Permeable
Cinchocaine 	Non-Permeable
Cinnamaldehyde 	Permeable
Cinnamyl alcohol 	Permeable
Cinnarizine 	Permeable
Cinoxacin 	Permeable
Cinoxate 	Permeable
Ciprofibrate 	Permeable
Ciprofloxacin 	Non-Permeable
Cisapride 	Permeable
Cisatracurium 	Non-Permeable
Citalopram 	Permeable
Citicoline 	Non-Permeable
Citric acid 	Non-Permeable
Cladribine 	Permeable
Clarithromycin 	Non-Permeable
Clascoterone 	Permeable
Clavulanic acid 	Permeable
Clemastine 	Permeable
Clenbuterol 	Permeable
Clevidipine 	Permeable
Clidinium 	Non-Permeable
Clindamycin 	Non-Permeable
Clioquinol 	Non-Permeable
Clobazam 	Permeable
Clobetasol 	Permeable
Clobetasol propionate 	Permeable
Clobetasone 	Permeable
Clocortolone 	Permeable
Clodronic acid 	Non-Permeable
Clofarabine 	Permeable
Clofazimine 	Non-Permeable
Clofedanol 	Permeable
Clofibrate 	Non-Permeable
Clomifene 	Permeable
Clomipramine 	Permeable
Clonazepam 	Permeable
Clonidine 	Permeable
Clopidogrel 	Permeable
Clorazepic acid 	Permeable
Clothiapine 	Permeable
Clotiazepam 	Permeable
Clotrimazole 	Non-Permeable
Cloxacillin 	Non-Permeable
Clozapine 	Permeable
Cobalt 	Permeable
Cobicistat 	Non-Permeable
Cobimetinib 	Non-Permeable
Cocaine 	Permeable
Cocarboxylase 	Permeable
Codeine 	Permeable
Coenzyme M 	Permeable
Colchiceine 	Non-Permeable
Colchicine 	Non-Permeable
Colfosceril palmitate 	Permeable
Colistimethate 	Non-Permeable
Colistin 	Non-Permeable
Conivaptan 	Non-Permeable
Copanlisib 	Permeable
Copper 	Permeable
Copper Cu-64 	Permeable
Copper gluconate 	Non-Permeable
Copper oxodotreotide Cu-64 	Non-Permeable
Cortisone acetate 	Permeable
Creatine 	Permeable
Crizotinib 	Non-Permeable
Cromoglicic acid 	Non-Permeable
Crotamiton 	Permeable
Cupric Chloride 	Permeable
Cupric sulfate 	Permeable
Curcumin 	Non-Permeable
Cyanocobalamin 	Non-Permeable
Cyanocobalamin Co-57 	Non-Permeable
Cyanocobalamin Co-60 	Non-Permeable
Cyclacillin 	Non-Permeable
Cyclandelate 	Permeable
Cyclizine 	Permeable
Cyclobenzaprine 	Permeable
Cycloguanil 	Permeable
Cyclopenthiazide 	Non-Permeable
Cyclopentolate 	Permeable
Cyclophosphamide 	Permeable
Cycloserine 	Permeable
Cyclosporine 	Non-Permeable
Cyclothiazide 	Non-Permeable
Cycrimine 	Permeable
Cyproheptadine 	Permeable
Cyproterone acetate 	Permeable
Cysteamine 	Permeable
Cysteine 	Permeable
Cystine 	Permeable
Cytarabine 	Permeable
Dabigatran 	Non-Permeable
Dabigatran etexilate 	Non-Permeable
Dabrafenib 	Non-Permeable
Dacarbazine 	Permeable
Daclatasvir 	Non-Permeable
Dacomitinib 	Non-Permeable
Dactinomycin 	Non-Permeable
Dalfampridine 	Permeable
Dalfopristin 	Non-Permeable
D-alpha-Tocopherol acetate 	Permeable
Danazol 	Permeable
Dantrolene 	Permeable
Dantron 	Non-Permeable
Dapagliflozin 	Permeable
Dapiprazole 	Permeable
Dapsone 	Permeable
Daptomycin 	Non-Permeable
Daridorexant 	Non-Permeable
Darifenacin 	Permeable
Darolutamide 	Non-Permeable
Darunavir 	Non-Permeable
Dasabuvir 	Non-Permeable
Dasatinib 	Non-Permeable
Daunorubicin 	Non-Permeable
Debrisoquine 	Permeable
Decamethonium 	Non-Permeable
Decitabine 	Permeable
Deferasirox 	Non-Permeable
Deferiprone 	Permeable
Deferoxamine 	Non-Permeable
Deflazacort 	Permeable
Degarelix 	Non-Permeable
Dehydrocholic acid 	Non-Permeable
Delafloxacin 	Non-Permeable
Delamanid 	Permeable
Delavirdine 	Non-Permeable
Demecarium 	Non-Permeable
Demeclocycline 	Non-Permeable
Deoxycholic acid 	Permeable
Dequalinium 	Permeable
Deserpidine 	Permeable
Desflurane 	Permeable
Desipramine 	Permeable
Deslanoside 	Non-Permeable
Desloratadine 	Permeable
Desmopressin 	Non-Permeable
Desogestrel 	Permeable
Desonide 	Permeable
Desoximetasone 	Permeable
Desoxycorticosterone acetate 	Permeable
Desvenlafaxine 	Permeable
Deucravacitinib 	Non-Permeable
Deutetrabenazine 	Permeable
Dexamethasone 	Permeable
Dexamethasone acetate 	Permeable
Dexamethasone metasulfobenzoate 	Permeable
Dexbrompheniramine 	Permeable
Dexchlorpheniramine maleate 	Permeable
Dexfenfluramine 	Permeable
Dexibuprofen 	Non-Permeable
Dexketoprofen 	Permeable
Dexlansoprazole 	Permeable
Dexmedetomidine 	Permeable
Dexmethylphenidate 	Permeable
Dexpanthenol 	Permeable
Dexrazoxane 	Non-Permeable
Dextroamphetamine 	Permeable
Dextromethorphan 	Permeable
Dextropropoxyphene 	Permeable
Dextrothyroxine 	Non-Permeable
Dezocine 	Permeable
D-glucose 	Non-Permeable
Diacerein 	Non-Permeable
Diacetyl benzoyl lathyrol 	Permeable
Diaminopropanol tetraacetic acid 	Non-Permeable
Diamorphine 	Permeable
Diatrizoate 	Non-Permeable
Diazepam 	Permeable
Diazolidinylurea 	Non-Permeable
Diazoxide 	Permeable
Dibekacin 	Non-Permeable
Dibenzepin 	Permeable
Dichloroacetic acid 	Permeable
Dichlorobenzyl alcohol 	Permeable
Diclofenac 	Non-Permeable
Diclofenamide 	Non-Permeable
Dicloxacillin 	Non-Permeable
Dicoumarol 	Non-Permeable
Dicyclomine 	Permeable
Didanosine 	Non-Permeable
Didecyldimethylammonium 	Permeable
Dienestrol 	Permeable
Dienogest 	Permeable
Diethylamino hydroxybenzoyl hexyl benzoate 	Permeable
Diethylcarbamazine 	Permeable
Diethylpropion 	Permeable
Diethylstilbestrol 	Non-Permeable
Diethyltoluamide 	Permeable
Difelikefalin 	Non-Permeable
Difenoxin 	Permeable
Diflorasone 	Permeable
Diflunisal 	Permeable
Difluocortolone 	Permeable
Difluprednate 	Permeable
Digitoxin 	Non-Permeable
Digoxin 	Non-Permeable
Dihydralazine 	Non-Permeable
Dihydro-alpha-ergocryptine 	Non-Permeable
Dihydrocodeine 	Permeable
Dihydroergocornine 	Non-Permeable
Dihydroergocristine 	Non-Permeable
Dihydroergotamine 	Non-Permeable
Dihydrostreptomycin 	Non-Permeable
Dihydrotachysterol 	Permeable
Diiodohydroxyquinoline 	Non-Permeable
Diloxanide furoate 	Permeable
Diltiazem 	Non-Permeable
Dimazole 	Permeable
Dimenhydrinate 	Permeable
Dimercaprol 	Non-Permeable
Dimercaptosuccinic acid 	Non-Permeable
Dimethyl fumarate 	Permeable
Dimethyl sulfoxide 	Permeable
Dimetindene 	Permeable
Dimetotiazine 	Permeable
Dinoprost 	Non-Permeable
Dinoprost tromethamine 	Permeable
Dinoprostone 	Non-Permeable
Dioctyldimonium 	Permeable
Diosmin 	Non-Permeable
Dioxybenzone 	Non-Permeable
Dipentamethylenethiuram disulfide 	Permeable
Diphemanil 	Non-Permeable
Diphenhydramine 	Permeable
Diphenidol 	Permeable
Diphenoxylate 	Permeable
Diphenylguanidine 	Permeable
Diphenylpyraline 	Permeable
Dipivefrin 	Non-Permeable
Dipotassium phosphate 	Non-Permeable
Dipyridamole 	Non-Permeable
Dipyrithione 	Permeable
Diroximel fumarate 	Permeable
Disopyramide 	Permeable
Disperse Blue 106 	Permeable
Distearyldimonium 	Permeable
Disulfiram 	Permeable
Ditiocarb zinc 	Permeable
DL-alpha tocopheryl acetate 	Permeable
DL-alpha-Tocopherol 	Permeable
DL-dimyristoylphosphatidylcholine 	Permeable
DL-dimyristoylphosphatidylglycerol 	Permeable
DL-Methylephedrine 	Permeable
D-Methionine 	Permeable
Dobutamine 	Permeable
Docetaxel 	Non-Permeable
Doconexent 	Permeable
Docosanol 	Permeable
Docusate 	Permeable
Dofetilide 	Permeable
Dolasetron 	Permeable
Dolutegravir 	Non-Permeable
Domiphen 	Non-Permeable
Domperidone 	Non-Permeable
Donepezil 	Permeable
Dopamine 	Non-Permeable
Dopexamine 	Permeable
Doravirine 	Non-Permeable
Doripenem 	Non-Permeable
Dorzolamide 	Permeable
Dosulepin 	Permeable
Dotatate 	Non-Permeable
Dotatate gallium Ga-68 	Non-Permeable
Doxacurium 	Non-Permeable
Doxapram 	Permeable
Doxazosin 	Permeable
Doxepin 	Permeable
Doxercalciferol 	Permeable
Doxorubicin 	Non-Permeable
Doxycycline 	Non-Permeable
Doxylamine 	Permeable
Drometrizole trisiloxane 	Non-Permeable
Dronabinol 	Permeable
Dronedarone 	Non-Permeable
Droperidol 	Permeable
Drospirenone 	Permeable
Drostanolone propionate 	Permeable
Drotaverine 	Permeable
Droxidopa 	Non-Permeable
D-Serine 	Non-Permeable
Duloxetine 	Permeable
Dutasteride 	Permeable
Duvelisib 	Non-Permeable
Dyclonine 	Permeable
Dydrogesterone 	Permeable
Dyphylline 	Permeable
Ebastine 	Non-Permeable
Ecamsule 	Permeable
Echothiophate 	Permeable
Econazole 	Non-Permeable
Edaravone 	Permeable
Edetate calcium disodium anhydrous 	Non-Permeable
Edetate disodium anhydrous 	Non-Permeable
Edetic acid 	Non-Permeable
Edotreotide gallium Ga-68 	Non-Permeable
Edoxaban 	Non-Permeable
Edoxudine 	Permeable
Edrophonium 	Non-Permeable
Efavirenz 	Non-Permeable
Efinaconazole 	Permeable
Eflornithine 	Permeable
Elagolix 	Non-Permeable
Elbasvir 	Non-Permeable
Eletriptan 	Non-Permeable
Elexacaftor 	Non-Permeable
Eliglustat 	Non-Permeable
Eltrombopag 	Non-Permeable
Eluxadoline 	Non-Permeable
Elvitegravir 	Non-Permeable
Emedastine 	Permeable
Empagliflozin 	Non-Permeable
Emtricitabine 	Non-Permeable
Enalapril 	Non-Permeable
Enalaprilat 	Non-Permeable
Enasidenib 	Non-Permeable
Encainide 	Permeable
Encorafenib 	Non-Permeable
Enflurane 	Permeable
Enoxacin 	Non-Permeable
Enoximone 	Permeable
Enprofylline 	Non-Permeable
Ensulizole 	Permeable
Entacapone 	Permeable
Entecavir 	Non-Permeable
Entrectinib 	Non-Permeable
Enzacamene 	Permeable
Enzalutamide 	Non-Permeable
Ephedrine 	Non-Permeable
Epicriptine 	Non-Permeable
Epinastine 	Non-Permeable
Epinephrine 	Non-Permeable
Epirubicin 	Non-Permeable
Eplerenone 	Permeable
Epoprostenol 	Non-Permeable
Eprosartan 	Permeable
Eravacycline 	Non-Permeable
Erdafitinib 	Non-Permeable
Erdosteine 	Non-Permeable
Ergocalciferol 	Permeable
Ergometrine 	Permeable
Ergosterol 	Permeable
Ergotamine 	Non-Permeable
Eribulin 	Permeable
Erlotinib 	Non-Permeable
Ertapenem 	Non-Permeable
Ertugliflozin 	Permeable
Erythrityl tetranitrate 	Permeable
Erythromycin 	Non-Permeable
Escitalopram 	Permeable
Esculin 	Non-Permeable
Esketamine 	Permeable
Eslicarbazepine 	Non-Permeable
Eslicarbazepine acetate 	Permeable
Esmolol 	Permeable
Esomeprazole 	Non-Permeable
Estazolam 	Permeable
Estetrol 	Non-Permeable
Estradiol 	Non-Permeable
Estradiol acetate 	Permeable
Estradiol benzoate 	Permeable
Estradiol cypionate 	Permeable
Estradiol dienanthate 	Permeable
Estradiol valerate 	Permeable
Estramustine 	Permeable
Estramustine phosphate 	Permeable
Estriol 	Non-Permeable
Estrone 	Non-Permeable
Estrone sulfate 	Non-Permeable
Eszopiclone 	Permeable
Etacrynic acid 	Non-Permeable
Etafedrine 	Permeable
Etelcalcetide 	Non-Permeable
Ethambutol 	Non-Permeable
Ethanol 	Non-Permeable
Ethanolamine oleate 	Permeable
Ethchlorvynol 	Permeable
Ethinamate 	Permeable
Ethinylestradiol 	Non-Permeable
Ethionamide 	Permeable
Ethoheptazine 	Permeable
Ethosuximide 	Permeable
Ethotoin 	Permeable
Ethyl chloride 	Permeable
Ethyl ferulate 	Non-Permeable
Ethyl hydroxybenzoate 	Permeable
Ethyl salicylate 	Non-Permeable
Ethylenediamine 	Permeable
Ethylhexyl methoxycrylene 	Permeable
Ethynodiol diacetate 	Permeable
Etidocaine 	Permeable
Etidronic acid 	Non-Permeable
Etilefrine 	Non-Permeable
Etodolac 	Non-Permeable
Etofamide 	Permeable
Etomidate 	Permeable
Etonogestrel 	Permeable
Etoposide 	Non-Permeable
Etoricoxib 	Permeable
Etravirine 	Non-Permeable
Eugenol 	Non-Permeable
Everolimus 	Non-Permeable
Exametazime 	Permeable
Exemestane 	Non-Permeable
Ezetimibe 	Permeable
Ezogabine 	Permeable
Famciclovir 	Permeable
Famotidine 	Permeable
Favipiravir 	Permeable
Febuxostat 	Permeable
Fedratinib 	Non-Permeable
Felbamate 	Permeable
Felodipine 	Non-Permeable
Fenbufen 	Permeable
Fenfluramine 	Permeable
Fenofibrate 	Permeable
Fenofibric acid 	Non-Permeable
Fenoldopam 	Non-Permeable
Fenoprofen 	Permeable
Fenoterol 	Non-Permeable
Fenpropidin 	Permeable
Fentanyl 	Permeable
Ferric ammonium citrate 	Non-Permeable
Ferric cation 	Permeable
Ferric chloride 	Permeable
Ferric derisomaltose 	Non-Permeable
Ferric glycerophosphate 	Non-Permeable
Ferric maltol 	Permeable
Ferric pyrophosphate citrate 	Non-Permeable
Ferric sulfate 	Permeable
Ferrous ascorbate 	Non-Permeable
Ferrous bisglycinate 	Non-Permeable
Ferrous cysteine glycinate 	Non-Permeable
Ferrous fumarate 	Non-Permeable
Ferrous gluconate 	Non-Permeable
Ferrous glycine sulfate 	Non-Permeable
Ferrous succinate 	Non-Permeable
Ferrous sulfate anhydrous 	Permeable
Fesoterodine 	Permeable
Fexinidazole 	Permeable
Fexofenadine 	Non-Permeable
Fidaxomicin 	Non-Permeable
Filgotinib 	Permeable
Finafloxacin 	Non-Permeable
Finasteride 	Permeable
Finerenone 	Permeable
Fingolimod 	Permeable
Flavin adenine dinucleotide 	Non-Permeable
Flavin mononucleotide 	Non-Permeable
Flavone 	Permeable
Flavoxate 	Permeable
Flecainide 	Permeable
Flibanserin 	Permeable
Floctafenine 	Permeable
Florbetaben (18F) 	Permeable
Florbetapir (18F) 	Permeable
Flortaucipir F-18 	Permeable
Flosequinan 	Permeable
Floxuridine 	Non-Permeable
Fluciclovine (18F) 	Permeable
Fluclorolone acetonide 	Permeable
Flucloxacillin 	Non-Permeable
Fluconazole 	Permeable
Flucytosine 	Permeable
Fludarabine 	Non-Permeable
Fludeoxyglucose (18F) 	Permeable
Fludrocortisone 	Permeable
Flufenamic acid 	Permeable
Fluindione 	Permeable
Flumazenil 	Permeable
Flumethasone 	Permeable
Flunarizine 	Permeable
Flunisolide 	Permeable
Flunitrazepam 	Permeable
Fluocinolone acetonide 	Permeable
Fluocinonide 	Permeable
Fluocortolone 	Permeable
Fluorescein 	Permeable
Fluoride ion 	Permeable
Fluoride ion F-18 	Permeable
Fluorodopa (18F) 	Non-Permeable
Fluoroestradiol F-18 	Non-Permeable
Fluorometholone 	Permeable
Fluorouracil 	Non-Permeable
Fluoxetine 	Permeable
Fluoxymesterone 	Permeable
Flupentixol 	Permeable
Fluphenazine 	Permeable
Fluprednisolone 	Permeable
Flurandrenolide 	Permeable
Flurazepam 	Permeable
Flurbiprofen 	Non-Permeable
Fluspirilene 	Permeable
Flutamide 	Permeable
Flutemetamol (18F) 	Permeable
Fluticasone 	Permeable
Fluticasone furoate 	Permeable
Fluticasone propionate 	Permeable
Fluvastatin 	Permeable
Fluvoxamine 	Permeable
Folic acid 	Permeable
Fomepizole 	Permeable
Fondaparinux 	Non-Permeable
Formaldehyde 	Permeable
Formestane 	Non-Permeable
Formoterol 	Non-Permeable
Fosamprenavir 	Non-Permeable
Fosaprepitant 	Non-Permeable
Foscarnet 	Permeable
Fosdenopterin 	Non-Permeable
Fosfomycin 	Permeable
Fosinopril 	Non-Permeable
Fosnetupitant 	Non-Permeable
Fosphenytoin 	Permeable
Fospropofol 	Permeable
Fostamatinib 	Non-Permeable
Fostemsavir 	Non-Permeable
Framycetin 	Non-Permeable
Frovatriptan 	Permeable
Fructose 	Permeable
Fulvestrant 	Permeable
Furosemide 	Non-Permeable
Fursultiamine 	Permeable
Fusafungine 	Non-Permeable
Fusidic acid 	Non-Permeable
Futibatinib 	Non-Permeable
Gabapentin 	Permeable
Gabapentin enacarbil 	Permeable
Gadobenic acid 	Non-Permeable
Gadobutrol 	Non-Permeable
Gadodiamide 	Non-Permeable
Gadofosveset trisodium 	Non-Permeable
Gadolinium 	Permeable
Gadopentetic acid 	Non-Permeable
Gadopiclenol 	Non-Permeable
Gadoteric acid 	Non-Permeable
Gadoteridol 	Non-Permeable
Gadoversetamide 	Non-Permeable
Gadoxetic acid 	Non-Permeable
Galactose 	Non-Permeable
Galantamine 	Permeable
Gallamine triethiodide 	Non-Permeable
Gallium citrate Ga-67 	Permeable
Gallium Ga-68 gozetotide 	Non-Permeable
Gallium nitrate 	Permeable
Gallium-68 PSMA 	Non-Permeable
gamma-Aminobutyric acid 	Permeable
gamma-Hydroxybutyric acid 	Non-Permeable
Gamolenic acid 	Permeable
Ganaxolone 	Permeable
Ganciclovir 	Permeable
Ganirelix 	Non-Permeable
Gatifloxacin 	Permeable
Gaxilose 	Non-Permeable
Gefitinib 	Non-Permeable
Gemcitabine 	Permeable
Gemeprost 	Permeable
Gemfibrozil 	Permeable
Gemifloxacin 	Non-Permeable
Gentamicin 	Non-Permeable
Gentian violet cation 	Non-Permeable
Geraniol 	Permeable
Gestonorone caproate 	Permeable
Gestrinone 	Permeable
Gilteritinib 	Non-Permeable
Gimeracil 	Permeable
Glasdegib 	Non-Permeable
Glecaprevir 	Non-Permeable
Gliclazide 	Permeable
Glimepiride 	Permeable
Glipizide 	Permeable
Gliquidone 	Permeable
Gluconic Acid 	Non-Permeable
Gluconolactone 	Permeable
Glucosamine 	Permeable
Glutamic acid 	Permeable
Glutathione 	Non-Permeable
Glutathione disulfide 	Non-Permeable
Glutethimide 	Permeable
Glyburide 	Non-Permeable
Glycerin 	Non-Permeable
Glycerol phenylbutyrate 	Permeable
Glycine 	Permeable
Glycol salicylate 	Non-Permeable
Glycolic acid 	Non-Permeable
Glycopyrronium 	Non-Permeable
Glycyrrhizic acid 	Non-Permeable
Glymidine 	Permeable
Gonadorelin 	Non-Permeable
Goserelin 	Non-Permeable
Gramicidin D 	Non-Permeable
Granisetron 	Permeable
Grazoprevir 	Non-Permeable
Grepafloxacin 	Non-Permeable
Griseofulvin 	Permeable
Guaiacol 	Non-Permeable
Guaifenesin 	Permeable
Guanabenz 	Non-Permeable
Guanadrel 	Non-Permeable
Guanethidine 	Non-Permeable
Guanfacine 	Permeable
Guanidine 	Permeable
Guanoxan 	Permeable
Halazepam 	Permeable
Halcinonide 	Permeable
Halofantrine 	Permeable
Haloperidol 	Permeable
Haloprogin 	Permeable
Halothane 	Permeable
Helium 	Permeable
Hesperidin 	Non-Permeable
Hetacillin 	Non-Permeable
Hexachlorophene 	Permeable
Hexafluronium 	Permeable
Hexamidine 	Non-Permeable
Hexaminolevulinate 	Permeable
Hexetidine 	Permeable
Hexobendine 	Permeable
Hexocyclium 	Permeable
Hexylcaine 	Permeable
Hexylresorcinol 	Non-Permeable
Histamine 	Permeable
Histrelin 	Non-Permeable
Homatropine 	Permeable
Homatropine methylbromide 	Non-Permeable
Homosalate 	Permeable
Huperzine A 	Permeable
Hyaluronic acid 	Non-Permeable
Hydralazine 	Non-Permeable
Hydrochlorothiazide 	Non-Permeable
Hydrocodone 	Permeable
Hydrocortamate 	Permeable
Hydrocortisone 	Non-Permeable
Hydrocortisone acetate 	Permeable
Hydrocortisone butyrate 	Permeable
Hydrocortisone cypionate 	Permeable
Hydrocortisone phosphate 	Permeable
Hydrocortisone probutate 	Permeable
Hydrocortisone succinate 	Permeable
Hydrocortisone valerate 	Permeable
Hydroflumethiazide 	Non-Permeable
Hydrogen fluoride 	Permeable
Hydrogen peroxide 	Non-Permeable
Hydromorphone 	Permeable
Hydroquinone 	Non-Permeable
Hydroxocobalamin 	Non-Permeable
Hydroxyamphetamine 	Non-Permeable
Hydroxychloroquine 	Non-Permeable
Hydroxycitronellal 	Permeable
Hydroxyethyl cellulose 	Non-Permeable
Hydroxyprogesterone caproate 	Permeable
Hydroxystilbamidine 	Permeable
Hydroxyurea 	Permeable
Hydroxyzine 	Permeable
Hyoscyamine 	Permeable
Hypochlorite 	Permeable
Ibandronate 	Permeable
Ibrexafungerp 	Non-Permeable
Ibrutinib 	Non-Permeable
Ibuprofen 	Non-Permeable
Ibutilide 	Permeable
Icatibant 	Non-Permeable
Icosapent 	Permeable
Icosapent ethyl 	Permeable
Idarubicin 	Non-Permeable
Idebenone 	Permeable
Idelalisib 	Non-Permeable
Idoxuridine 	Permeable
Ifosfamide 	Permeable
Iloperidone 	Permeable
Iloprost 	Permeable
Imatinib 	Non-Permeable
Imidurea 	Non-Permeable
Imipenem 	Non-Permeable
Imipramine 	Permeable
Imiquimod 	Permeable
Indacaterol 	Non-Permeable
Indapamide 	Permeable
Indecainide 	Permeable
Indigotindisulfonic acid 	Non-Permeable
Indinavir 	Non-Permeable
Indium In-111 chloride 	Permeable
Indium In-111 oxyquinoline 	Non-Permeable
Indium In-111 pentetate 	Non-Permeable
Indium In-111 pentetreotide 	Non-Permeable
Indocyanine green 	Permeable
Indocyanine green acid form 	Permeable
Indomethacin 	Non-Permeable
Indoramin 	Permeable
Infigratinib 	Non-Permeable
Ingenol mebutate 	Permeable
Inosine pranobex 	Non-Permeable
Inositol 	Non-Permeable
Inositol nicotinate 	Non-Permeable
Iobenguane 	Permeable
Iobenguane sulfate I-123 	Non-Permeable
Iobitridol 	Non-Permeable
Iocetamic acid 	Permeable
Iodide 	Permeable
Iodide I-123 	Permeable
Iodide I-131 	Permeable
Iodine 	Permeable
Iodipamide 	Non-Permeable
Iodixanol 	Non-Permeable
Iodoform 	Permeable
Iodohippurate sodium I-123 	Permeable
Iodohippurate sodium I-131 	Permeable
Iofetamine I-123 	Permeable
Ioflupane I-123 	Permeable
Iohexol 	Non-Permeable
Iomeprol 	Non-Permeable
Iopamidol 	Non-Permeable
Iopanoic acid 	Non-Permeable
Iophendylate 	Permeable
Iopodic acid 	Non-Permeable
Iopromide 	Non-Permeable
Iothalamic acid 	Non-Permeable
Iotrolan 	Non-Permeable
Ioversol 	Non-Permeable
Ioxaglic acid 	Non-Permeable
Ioxilan 	Non-Permeable
Ioxitalamic acid 	Non-Permeable
Ipratropium 	Non-Permeable
Irbesartan 	Permeable
Irinotecan 	Permeable
Iron 	Permeable
Iron sucrose 	Non-Permeable
Isavuconazole 	Permeable
Isavuconazonium 	Non-Permeable
Isoaminile 	Permeable
Isocarboxazid 	Permeable
Isoconazole 	Permeable
Isoetharine 	Non-Permeable
Isoeugenol 	Non-Permeable
Isoflurane 	Permeable
Isoflurophate 	Permeable
Isometheptene 	Permeable
Isoniazid 	Permeable
Isoprenaline 	Non-Permeable
Isopropamide 	Permeable
Isopropyl alcohol 	Non-Permeable
Isopropyl myristate 	Permeable
Isosorbide 	Permeable
Isosorbide dinitrate 	Permeable
Isosorbide mononitrate 	Permeable
Isosulfan blue 	Non-Permeable
Isotretinoin 	Permeable
Isoxaflutole 	Permeable
Isoxicam 	Non-Permeable
Isoxsuprine 	Permeable
Isradipine 	Permeable
Istradefylline 	Permeable
Itraconazole 	Non-Permeable
Ivabradine 	Permeable
Ivacaftor 	Non-Permeable
Ivermectin 	Non-Permeable
Ivosidenib 	Non-Permeable
Ixabepilone 	Non-Permeable
Ixazomib 	Permeable
Kanamycin 	Non-Permeable
Kappadione 	Non-Permeable
Kava 	Permeable
Ketamine 	Permeable
Ketazolam 	Permeable
Ketoconazole 	Non-Permeable
Ketoprofen 	Permeable
Ketorolac 	Non-Permeable
Ketotifen 	Permeable
Kinetin 	Permeable
Krypton Kr 81m 	Permeable
Labetalol 	Non-Permeable
Lacidipine 	Permeable
Lacosamide 	Permeable
Lactic acid 	Permeable
Lactitol 	Non-Permeable
Lactose 	Non-Permeable
Lactulose 	Non-Permeable
Lamivudine 	Permeable
Lamotrigine 	Permeable
Lanreotide 	Non-Permeable
Lansoprazole 	Permeable
Lanthanum carbonate 	Permeable
Lapatinib 	Non-Permeable
Lapyrium 	Non-Permeable
Laropiprant 	Permeable
Larotrectinib 	Non-Permeable
Lasmiditan 	Permeable
Lasofoxifene 	Permeable
Latamoxef 	Non-Permeable
Latanoprost 	Permeable
Latanoprostene bunod 	Non-Permeable
Lauric acid 	Permeable
Laurocapram 	Permeable
Ledipasvir 	Non-Permeable
Lefamulin 	Permeable
Leflunomide 	Permeable
Lemborexant 	Permeable
Lenalidomide 	Permeable
Lenvatinib 	Permeable
Lercanidipine 	Non-Permeable
Lesinurad 	Non-Permeable
Letermovir 	Permeable
Letrozole 	Permeable
Leucovorin 	Non-Permeable
Leuprolide 	Non-Permeable
Levacetylmethadol 	Permeable
Levallorphan 	Permeable
Levamisole 	Permeable
Levamlodipine 	Permeable
Levetiracetam 	Permeable
Levmetamfetamine 	Permeable
Levobetaxolol 	Permeable
Levobunolol 	Permeable
Levobupivacaine 	Permeable
Levocabastine 	Permeable
Levocarnitine 	Non-Permeable
Levocetirizine 	Non-Permeable
Levodopa 	Non-Permeable
Levofloxacin 	Permeable
Levoketoconazole 	Non-Permeable
Levoleucovorin 	Non-Permeable
Levomefolic acid 	Non-Permeable
Levomenol 	Permeable
Levomenthol 	Permeable
Levomilnacipran 	Permeable
Levonordefrin 	Non-Permeable
Levonorgestrel 	Permeable
Levorphanol 	Permeable
Levosalbutamol 	Non-Permeable
Levosimendan 	Permeable
Levothyroxine 	Non-Permeable
L-Glutamine 	Permeable
Lidocaine 	Permeable
Lidoflazine 	Permeable
Lifitegrast 	Non-Permeable
Light green SF yellowish 	Non-Permeable
Linaclotide 	Non-Permeable
Linagliptin 	Permeable
Lincomycin 	Non-Permeable
Lindane 	Permeable
Linezolid 	Permeable
Linoleic acid 	Permeable
Linzagolix 	Non-Permeable
Liothyronine 	Non-Permeable
Liotrix 	Non-Permeable
Lipoic acid 	Permeable
Lisdexamfetamine 	Permeable
Lisinopril 	Non-Permeable
Lisuride 	Permeable
Lithium carbonate 	Non-Permeable
Lithium citrate 	Permeable
Lithium hydroxide 	Invalid SMILES
L-Lactic acid 	Permeable
Lodoxamide 	Non-Permeable
Lofexidine 	Permeable
Lomefloxacin 	Non-Permeable
Lomitapide 	Non-Permeable
Lomustine 	Permeable
Lonafarnib 	Non-Permeable
Loperamide 	Non-Permeable
Lopinavir 	Non-Permeable
Loracarbef 	Non-Permeable
Loratadine 	Non-Permeable
Lorazepam 	Permeable
Lorcaserin 	Permeable
Lorlatinib 	Non-Permeable
Lormetazepam 	Permeable
Lornoxicam 	Permeable
Lorpiprazole 	Permeable
Losartan 	Non-Permeable
Loteprednol 	Permeable
Loteprednol etabonate 	Permeable
Lovastatin 	Non-Permeable
Loxapine 	Permeable
Loxoprofen 	Permeable
Lubiprostone 	Permeable
Luliconazole 	Permeable
Lumacaftor 	Non-Permeable
Lumateperone 	Permeable
Lumefantrine 	Permeable
Lumefantrine co-artemether 	Permeable
Lumiracoxib 	Non-Permeable
Lurasidone 	Permeable
Lurbinectedin 	Non-Permeable
Lusutrombopag 	Non-Permeable
Lutein 	Non-Permeable
Lutetium Lu 177 dotatate 	Non-Permeable
Lutetium Lu-177 	Permeable
Lutetium Lu-177 vipivotide tetraxetan 	Non-Permeable
Lycopene 	Permeable
Lymecycline 	Non-Permeable
Lynestrenol 	Permeable
Lypressin 	Non-Permeable
Lysine 	Non-Permeable
Macimorelin 	Non-Permeable
Macitentan 	Non-Permeable
Mafenide 	Permeable
Magnesium 	Permeable
Magnesium acetate 	Permeable
Magnesium acetate tetrahydrate 	Non-Permeable
Magnesium ascorbate 	Non-Permeable
Magnesium carbonate 	Non-Permeable
Magnesium cation 	Permeable
Magnesium chloride 	Invalid SMILES
Magnesium citrate 	Non-Permeable
Magnesium gluconate 	Non-Permeable
Magnesium glycinate 	Non-Permeable
Magnesium hydroxide 	Invalid SMILES
Magnesium malate 	Non-Permeable
Magnesium oxide 	Invalid SMILES
Magnesium silicate 	Invalid SMILES
Magnesium sulfate 	Permeable
Magnesium trisilicate 	Permeable
Malathion 	Permeable
Mandelic acid 	Non-Permeable
Mangafodipir 	Non-Permeable
Manganese 	Permeable
Manganese citrate 	Non-Permeable
Manganese gluconate 	Non-Permeable
Manidipine 	Non-Permeable
Mannitol 	Non-Permeable
Mannitol busulfan 	Permeable
Maprotiline 	Permeable
Maralixibat 	Non-Permeable
Maraviroc 	Permeable
Maribavir 	Non-Permeable
Masoprocol 	Non-Permeable
Mavacamten 	Permeable
Mazindol 	Permeable
Mebendazole 	Permeable
Mebeverine 	Permeable
Mebrofenin 	Permeable
Mebutamate 	Permeable
Mecamylamine 	Permeable
Mechlorethamine 	Permeable
Meclizine 	Permeable
Meclofenamic acid 	Non-Permeable
Mecobalamin 	Non-Permeable
Medifoxamine 	Permeable
Medrogestone 	Permeable
Medronic acid 	Non-Permeable
Medroxyprogesterone acetate 	Permeable
Medrysone 	Permeable
Mefenamic acid 	Non-Permeable
Mefloquine 	Permeable
Megestrol acetate 	Permeable
Meglumine 	Non-Permeable
Melatonin 	Permeable
Meloxicam 	Non-Permeable
Melphalan 	Non-Permeable
Melphalan flufenamide 	Non-Permeable
Memantine 	Permeable
Menadiol diphosphate 	Non-Permeable
Menadione 	Non-Permeable
Menthol 	Permeable
Menthyl salicylate 	Permeable
Mepenzolate 	Non-Permeable
Meperidine 	Permeable
Mephenesin 	Permeable
Mephentermine 	Permeable
Mephenytoin 	Permeable
Mepivacaine 	Permeable
Meprednisone 	Permeable
Meprobamate 	Non-Permeable
Mepyramine 	Permeable
Mequinol 	Non-Permeable
Meradimate 	Permeable
Mercaptopurine 	Non-Permeable
Meropenem 	Non-Permeable
Mesalazine 	Non-Permeable
Mesoridazine 	Permeable
Mestranol 	Non-Permeable
Metacycline 	Non-Permeable
Metamfetamine 	Permeable
Metamizole 	Non-Permeable
Metaraminol 	Non-Permeable
Metaxalone 	Permeable
Metergoline 	Permeable
Metformin 	Permeable
Methacholine 	Non-Permeable
Methadone 	Permeable
Methantheline 	Non-Permeable
Methazolamide 	Permeable
Methdilazine 	Permeable
Methenamine 	Permeable
Methimazole 	Permeable
Methionine 	Permeable
Methocarbamol 	Permeable
Methohexital 	Permeable
Methotrexate 	Non-Permeable
Methotrimeprazine 	Permeable
Methoxamine 	Permeable
Methoxsalen 	Non-Permeable
Methoxyflurane 	Permeable
Methoxyphenamine 	Permeable
Methscopolamine 	Non-Permeable
Methscopolamine bromide 	Non-Permeable
Methsuximide 	Permeable
Methyl aminolevulinate 	Permeable
Methyl nicotinate 	Permeable
Methyl salicylate 	Non-Permeable
Methylchloroisothiazolinone 	Permeable
Methyldopa 	Non-Permeable
Methylene blue 	Permeable
Methylergometrine 	Permeable
Methylnaltrexone 	Permeable
Methylparaben 	Non-Permeable
Methylphenidate 	Permeable
Methylphenobarbital 	Permeable
Methylprednisolone 	Permeable
Methylprednisolone aceponate 	Permeable
Methylprednisolone hemisuccinate 	Permeable
Methylprednisone 	Permeable
Methyltestosterone 	Non-Permeable
Methyprylon 	Permeable
Methysergide 	Permeable
Meticillin 	Non-Permeable
Meticrane 	Permeable
Metipranolol 	Permeable
Metixene 	Permeable
Metoclopramide 	Permeable
Metocurine 	Non-Permeable
Metocurine iodide 	Non-Permeable
Metolazone 	Permeable
Metoprolol 	Permeable
Metrizoic acid 	Non-Permeable
Metronidazole 	Permeable
Metyrapone 	Permeable
Metyrosine 	Non-Permeable
Mexiletine 	Permeable
Mezlocillin 	Non-Permeable
Mianserin 	Permeable
Micafungin 	Non-Permeable
Miconazole 	Permeable
Micronomicin 	Non-Permeable
Midazolam 	Permeable
Midodrine 	Permeable
Midostaurin 	Permeable
Mifamurtide 	Non-Permeable
Mifepristone 	Non-Permeable
Migalastat 	Non-Permeable
Miglitol 	Non-Permeable
Miglustat 	Non-Permeable
Milnacipran 	Permeable
Milrinone 	Permeable
Miltefosine 	Permeable
Minaprine 	Permeable
Minocycline 	Non-Permeable
Minoxidil 	Permeable
Mirabegron 	Permeable
Mirtazapine 	Permeable
Misoprostol 	Permeable
Mitapivat 	Permeable
Mitomycin 	Non-Permeable
Mitotane 	Permeable
Mitoxantrone 	Non-Permeable
Mivacurium 	Non-Permeable
Mizolastine 	Permeable
Mobocertinib 	Non-Permeable
Moclobemide 	Permeable
Modafinil 	Permeable
Moexipril 	Non-Permeable
Molindone 	Permeable
Molsidomine 	Permeable
Molybdenum 	Permeable
Mometasone furoate 	Permeable
Monobenzone 	Permeable
Monomethyl fumarate 	Non-Permeable
Monopotassium phosphate 	Non-Permeable
Montelukast 	Non-Permeable
Moricizine 	Permeable
Morphine 	Permeable
Morpholinylmercaptobenzothiazole 	Permeable
Moxidectin 	Non-Permeable
Moxifloxacin 	Non-Permeable
Moxisylyte 	Permeable
Moxonidine 	Permeable
Mupirocin 	Non-Permeable
Muzolimine 	Permeable
Mycophenolate mofetil 	Permeable
Mycophenolic acid 	Permeable
Nabilone 	Permeable
Nabumetone 	Permeable
N-Acetylglucosamine 	Permeable
N-acetyltyrosine 	Permeable
NADH 	Non-Permeable
Nadolol 	Non-Permeable
Nafarelin 	Non-Permeable
Nafcillin 	Non-Permeable
Naftazone 	Permeable
Naftifine 	Permeable
Nalbuphine 	Permeable
Naldemedine 	Non-Permeable
Nalidixic acid 	Non-Permeable
Nalmefene 	Permeable
Naloxegol 	Permeable
Naloxone 	Permeable
Naltrexone 	Permeable
Nandrolone decanoate 	Permeable
Nandrolone phenpropionate 	Permeable
Naphazoline 	Permeable
Naproxen 	Non-Permeable
Naratriptan 	Non-Permeable
Natamycin 	Non-Permeable
Nateglinide 	Permeable
"N-Cyclohexyl-N'-phenyl-1 	Permeable
Nebivolol 	Permeable
Nedaplatin 	Permeable
Nedocromil 	Non-Permeable
Nefazodone 	Permeable
Nefopam 	Permeable
Nelarabine 	Permeable
Nelfinavir 	Non-Permeable
Neon 	Permeable
Neostigmine 	Non-Permeable
Nepafenac 	Permeable
Neratinib 	Non-Permeable
Netarsudil 	Permeable
Netilmicin 	Non-Permeable
Netupitant 	Permeable
Nevirapine 	Permeable
Niacin 	Permeable
Niacinamide ascorbate 	Non-Permeable
Nialamide 	Permeable
Nicardipine 	Non-Permeable
Nicergoline 	Permeable
Nickel sulfate 	Permeable
Niclosamide 	Non-Permeable
Nicoboxil 	Permeable
Nicorandil 	Permeable
Nicotinamide 	Permeable
Nicotine 	Permeable
Nifedipine 	Non-Permeable
Nifurtimox 	Permeable
Nilotinib 	Non-Permeable
Nilutamide 	Permeable
Nilvadipine 	Permeable
Nimesulide 	Permeable
Nimodipine 	Permeable
Nintedanib 	Non-Permeable
Niraparib 	Non-Permeable
Nirmatrelvir 	Non-Permeable
Nisoldipine 	Permeable
Nitazoxanide 	Permeable
Nitisinone 	Permeable
Nitrazepam 	Permeable
Nitrendipine 	Non-Permeable
Nitric Oxide 	Permeable
Nitrite 	Permeable
Nitrofural 	Non-Permeable
Nitrofurantoin 	Permeable
Nitrogen 	Permeable
Nitroglycerin 	Permeable
Nitroprusside 	Permeable
Nitrous acid 	Permeable
Nitrous oxide 	Permeable
Nizatidine 	Permeable
Nomegestrol 	Permeable
Nomegestrol acetate 	Permeable
Nomifensine 	Permeable
Nonoxynol-9 	Permeable
Norelgestromin 	Permeable
Norepinephrine 	Non-Permeable
Norethisterone 	Non-Permeable
Norethynodrel 	Permeable
Norfloxacin 	Non-Permeable
Norflurane 	Permeable
Norgestimate 	Permeable
Norgestrel 	Permeable
Normethadone 	Permeable
Nortriptyline 	Permeable
Noscapine 	Permeable
Novobiocin 	Non-Permeable
Noxytiolin 	Permeable
Nylidrin 	Non-Permeable
Nystatin 	Non-Permeable
Obeticholic acid 	Permeable
Octasulfur 	Permeable
Octinoxate 	Permeable
Octisalate 	Permeable
Octocrylene 	Permeable
Odevixibat 	Non-Permeable
Ofloxacin 	Permeable
Oftasceine 	Non-Permeable
Olanzapine 	Permeable
Olaparib 	Permeable
Oleic Acid 	Permeable
Oliceridine 	Permeable
Olmesartan 	Permeable
Olodaterol 	Non-Permeable
Olopatadine 	Permeable
Olsalazine 	Non-Permeable
Olutasidenib 	Permeable
Omacetaxine mepesuccinate 	Permeable
Omadacycline 	Non-Permeable
Ombitasvir 	Non-Permeable
Omeprazole 	Non-Permeable
Omidenepag isopropyl 	Non-Permeable
Ondansetron 	Permeable
Opicapone 	Non-Permeable
Orciprenaline 	Permeable
Oritavancin 	Non-Permeable
Orlistat 	Permeable
Ornithine 	Permeable
Orphenadrine 	Non-Permeable
Oseltamivir 	Permeable
Osilodrostat 	Permeable
Osimertinib 	Non-Permeable
Ospemifene 	Permeable
Oteracil 	Permeable
Oteseconazole 	Non-Permeable
Ouabain 	Non-Permeable
Oxacillin 	Non-Permeable
Oxaliplatin 	Permeable
Oxamniquine 	Permeable
Oxandrolone 	Non-Permeable
Oxaprozin 	Non-Permeable
Oxatomide 	Permeable
Oxazepam 	Permeable
Oxcarbazepine 	Permeable
Oxeladin 	Permeable
Oxetacaine 	Non-Permeable
Oxiconazole 	Permeable
Oxidronic acid 	Non-Permeable
Oxilofrine 	Non-Permeable
Oxitriptan 	Permeable
Oxolamine 	Permeable
Oxprenolol 	Permeable
Oxtriphylline 	Permeable
Oxybenzone 	Permeable
Oxybuprocaine 	Permeable
Oxybutynin 	Permeable
Oxycodone 	Permeable
Oxygen 	Permeable
Oxymetazoline 	Permeable
Oxymetholone 	Non-Permeable
Oxymorphone 	Permeable
Oxyphenbutazone 	Permeable
Oxyphencyclimine 	Permeable
Oxyphenisatin acetate 	Permeable
Oxyphenonium 	Non-Permeable
Oxyquinoline 	Permeable
Oxytetracycline 	Non-Permeable
Ozanimod 	Non-Permeable
Ozenoxacin 	Non-Permeable
Paclitaxel 	Non-Permeable
Pacritinib 	Non-Permeable
Padeliporfin 	Non-Permeable
Padimate O 	Permeable
Pafolacianine 	Non-Permeable
Palbociclib 	Non-Permeable
Paliperidone 	Permeable
Palmitic Acid 	Permeable
Palonosetron 	Permeable
Palovarotene 	Non-Permeable
Pamidronic acid 	Non-Permeable
Pancuronium 	Non-Permeable
Panobinostat 	Permeable
Pantethine 	Non-Permeable
Panthenol 	Permeable
Pantoprazole 	Permeable
Pantothenic acid 	Permeable
Papaverine 	Non-Permeable
Parachlorophenol 	Permeable
Paraldehyde 	Permeable
Paramethadione 	Permeable
Paramethasone acetate 	Permeable
Parecoxib 	Permeable
Pargyline 	Permeable
Paricalcitol 	Permeable
Paritaprevir 	Non-Permeable
Paromomycin 	Non-Permeable
Paroxetine 	Permeable
Parthenolide 	Permeable
Pasireotide 	Non-Permeable
Patent Blue 	Non-Permeable
Pazopanib 	Non-Permeable
PBT-434 	Permeable
Pefloxacin 	Non-Permeable
Pemetrexed 	Non-Permeable
Pemigatinib 	Permeable
Pemirolast 	Permeable
Pemoline 	Permeable
Penbutolol 	Permeable
Penciclovir 	Permeable
Penicillamine 	Permeable
Pentaerythritol tetranitrate 	Non-Permeable
Pentafluoropropane 	Permeable
Pentagastrin 	Non-Permeable
Pentamidine 	Non-Permeable
Pentazocine 	Permeable
Pentetic acid 	Non-Permeable
Pentetreotide 	Non-Permeable
Pentobarbital 	Permeable
Pentolinium 	Non-Permeable
Pentosan polysulfate 	Non-Permeable
Pentostatin 	Permeable
Pentoxifylline 	Permeable
Pentoxyverine 	Permeable
Peramivir 	Non-Permeable
Perampanel 	Permeable
Perazine 	Permeable
Perboric acid 	Non-Permeable
Perflexane 	Permeable
Perflubutane 	Permeable
Perflutren 	Permeable
Pergolide 	Permeable
Perhexiline 	Permeable
Periciazine 	Permeable
Perindopril 	Permeable
Permethrin 	Non-Permeable
Perphenazine 	Permeable
Pexidartinib 	Permeable
Phenacemide 	Permeable
Phenazopyridine 	Non-Permeable
Phendimetrazine 	Permeable
Phenelzine 	Permeable
Pheneticillin 	Non-Permeable
Phenformin 	Permeable
Phenindamine 	Permeable
Phenindione 	Permeable
Pheniramine 	Permeable
Phenmetrazine 	Permeable
Phenobarbital 	Permeable
Phenol 	Permeable
Phenolphthalein 	Non-Permeable
Phenoxybenzamine 	Non-Permeable
Phenoxymethylpenicillin 	Non-Permeable
Phenprocoumon 	Permeable
Phensuximide 	Permeable
Phentermine 	Permeable
Phentolamine 	Permeable
Phenyl aminosalicylate 	Permeable
Phenyl salicylate 	Permeable
Phenylacetic acid 	Permeable
Phenylalanine 	Permeable
Phenylbutazone 	Non-Permeable
Phenylbutyric acid 	Permeable
Phenylephrine 	Non-Permeable
Phenylethyl resorcinol 	Permeable
Phenylpropanolamine 	Permeable
Phenyltoloxamine 	Permeable
Phenytoin 	Permeable
Phloxine B 	Non-Permeable
Pholcodine 	Permeable
Phosphoric acid 	Permeable
Phosphorus 	Permeable
Phthalylsulfathiazole 	Non-Permeable
Phylloquinone 	Permeable
Physostigmine 	Permeable
Pibrentasvir 	Non-Permeable
Picosulfuric acid 	Non-Permeable
Pidolic acid 	Permeable
Piflufolastat F 18 	Non-Permeable
Pilocarpine 	Permeable
Pimavanserin 	Permeable
Pimecrolimus 	Non-Permeable
Pimethixene 	Permeable
Pimozide 	Permeable
Pinacidil 	Non-Permeable
Pinaverium 	Non-Permeable
Pindolol 	Permeable
Pioglitazone 	Permeable
Pipecuronium 	Non-Permeable
Piperacillin 	Non-Permeable
Piperaquine 	Permeable
Piperazine 	Permeable
Piperonyl butoxide 	Permeable
Pipobroman 	Permeable
Pipotiazine 	Permeable
Pipradrol 	Permeable
Piracetam 	Permeable
Pirbuterol 	Non-Permeable
Pirenzepine 	Permeable
Piretanide 	Permeable
Pirfenidone 	Permeable
Piritramide 	Permeable
Piroxicam 	Non-Permeable
Pitavastatin 	Permeable
Pitolisant 	Permeable
Pivampicillin 	Non-Permeable
Pivmecillinam 	Non-Permeable
Pixantrone 	Permeable
Pizotifen 	Permeable
Plazomicin 	Non-Permeable
Plecanatide 	Non-Permeable
Plerixafor 	Permeable
Plicamycin 	Permeable
P-nitrobiphenyl 	Permeable
Podofilox 	Permeable
Podophyllin 	Non-Permeable
Polidocanol 	Permeable
Polydatin 	Non-Permeable
Polymyxin B 	Non-Permeable
Polythiazide 	Non-Permeable
Pomalidomide 	Non-Permeable
Ponatinib 	Permeable
Ponesimod 	Non-Permeable
Posaconazole 	Non-Permeable
Potassium 	Permeable
Potassium acetate 	Non-Permeable
Potassium aspartate 	Non-Permeable
Potassium bicarbonate 	Non-Permeable
Potassium carbonate 	Non-Permeable
Potassium cation 	Permeable
Potassium chloride 	Invalid SMILES
Potassium citrate 	Non-Permeable
Potassium gluconate 	Non-Permeable
Potassium hydroxide 	Invalid SMILES
Potassium Iodide 	Invalid SMILES
Potassium lactate 	Non-Permeable
Potassium nitrate 	Permeable
Potassium perchlorate 	Permeable
Potassium sulfate 	Permeable
p-Phenylenediamine 	Permeable
Practolol 	Non-Permeable
Pralatrexate 	Non-Permeable
Pralidoxime 	Non-Permeable
Pralsetinib 	Non-Permeable
Pramipexole 	Permeable
Pramiracetam 	Permeable
Pramlintide 	Non-Permeable
Pramocaine 	Permeable
Prasterone 	Non-Permeable
Prasterone enantate 	Permeable
Prasugrel 	Permeable
Pravastatin 	Non-Permeable
Prazepam 	Permeable
Praziquantel 	Permeable
Prazosin 	Non-Permeable
Prednicarbate 	Permeable
Prednisolone 	Non-Permeable
Prednisolone acetate 	Permeable
Prednisolone phosphate 	Permeable
Prednisolone tebutate 	Permeable
Prednisone 	Non-Permeable
Prednisone acetate 	Permeable
Pregabalin 	Permeable
Pregnenolone 	Permeable
Prenylamine 	Permeable
Pretomanid 	Permeable
Prilocaine 	Permeable
Primaquine 	Non-Permeable
Primidone 	Permeable
Probenecid 	Non-Permeable
Probucol 	Permeable
Procainamide 	Permeable
Procaine 	Non-Permeable
Procaine benzylpenicillin 	Non-Permeable
Procaine merethoxylline 	Non-Permeable
Procarbazine 	Permeable
Procaterol 	Non-Permeable
Prochlorperazine 	Permeable
Procyclidine 	Permeable
Profenamine 	Permeable
Proflavine 	Permeable
Progesterone 	Non-Permeable
Proguanil 	Permeable
Promazine 	Permeable
Promethazine 	Permeable
Propafenone 	Non-Permeable
Propanoic acid 	Non-Permeable
Propantheline 	Non-Permeable
Proparacaine 	Permeable
Propiolactone 	Permeable
Propiomazine 	Permeable
Propiverine 	Permeable
Propofol 	Permeable
Propoxycaine 	Permeable
Propranolol 	Non-Permeable
Propyl alcohol 	Non-Permeable
Propylene glycol 	Non-Permeable
Propylhexedrine 	Permeable
Propyliodone 	Permeable
Propylparaben 	Permeable
Propylthiouracil 	Permeable
Protionamide 	Permeable
Protirelin 	Non-Permeable
Protokylol 	Permeable
Protriptyline 	Permeable
Proxibarbal 	Permeable
Prucalopride 	Non-Permeable
Prussian blue 	Permeable
Pseudoephedrine 	Non-Permeable
Pyrantel 	Permeable
Pyrazinamide 	Permeable
Pyridostigmine 	Permeable
Pyridoxal phosphate 	Non-Permeable
Pyridoxine 	Non-Permeable
Pyrimethamine 	Permeable
Pyrithione 	Permeable
Pyrophosphoric acid 	Non-Permeable
Pyruvic acid 	Non-Permeable
Pyrvinium 	Permeable
Quaternium-15 	Permeable
Quazepam 	Permeable
Quetiapine 	Permeable
Quinagolide 	Permeable
Quinapril 	Non-Permeable
Quinestrol 	Permeable
Quinethazone 	Permeable
Quinidine 	Non-Permeable
Quinidine barbiturate 	Permeable
Quinine 	Non-Permeable
Quinupramine 	Permeable
Quinupristin 	Non-Permeable
Rabeprazole 	Permeable
Racemethionine 	Permeable
Racephedrine 	Non-Permeable
Radium Ra 223 dichloride 	Invalid SMILES
Raloxifene 	Non-Permeable
Raltegravir 	Non-Permeable
Raltitrexed 	Non-Permeable
Ramelteon 	Permeable
Ramipril 	Permeable
Ranitidine 	Non-Permeable
Ranolazine 	Permeable
Rapacuronium 	Non-Permeable
Rasagiline 	Permeable
Rebamipide 	Non-Permeable
Reboxetine 	Permeable
Regadenoson 	Non-Permeable
Regorafenib 	Non-Permeable
Relebactam 	Non-Permeable
Relugolix 	Non-Permeable
Remdesivir 	Non-Permeable
Remifentanil 	Permeable
Remimazolam 	Permeable
Remoxipride 	Permeable
Repaglinide 	Permeable
Rescinnamine 	Permeable
Reserpine 	Permeable
Resorcinol 	Non-Permeable
Resorcinol monoacetate 	Permeable
Retapamulin 	Permeable
Revefenacin 	Non-Permeable
Ribavirin 	Permeable
Ribociclib 	Non-Permeable
Riboflavin 	Permeable
Ribostamycin 	Non-Permeable
Rifabutin 	Non-Permeable
Rifampicin 	Non-Permeable
Rifamycin 	Non-Permeable
Rifapentine 	Non-Permeable
Rifaximin 	Non-Permeable
Rilmenidine 	Permeable
Rilpivirine 	Non-Permeable
Riluzole 	Permeable
Rimantadine 	Permeable
Rimegepant 	Permeable
Rimexolone 	Permeable
Rimonabant 	Non-Permeable
Riociguat 	Permeable
Ripretinib 	Non-Permeable
Risdiplam 	Non-Permeable
Risedronic acid 	Non-Permeable
Risperidone 	Permeable
Ritiometan 	Non-Permeable
Ritodrine 	Permeable
Ritonavir 	Non-Permeable
Rivaroxaban 	Permeable
Rivastigmine 	Permeable
Rizatriptan 	Non-Permeable
Rocuronium 	Non-Permeable
Rofecoxib 	Non-Permeable
Roflumilast 	Permeable
Rolapitant 	Permeable
Rolitetracycline 	Non-Permeable
Romidepsin 	Non-Permeable
Ropinirole 	Permeable
Ropivacaine 	Permeable
Rose bengal 	Non-Permeable
Rose bengal I-131 	Non-Permeable
Rosiglitazone 	Permeable
Rosoxacin 	Non-Permeable
Rosuvastatin 	Non-Permeable
Rotigotine 	Permeable
Roxadustat 	Non-Permeable
Roxithromycin 	Non-Permeable
Rubidium 	Permeable
Rubidium Rb-82 	Permeable
Rucaparib 	Permeable
Rufinamide 	Permeable
Rupatadine 	Permeable
Rutin 	Non-Permeable
Ruxolitinib 	Permeable
Sacubitril 	Permeable
Safinamide 	Permeable
Salbutamol 	Non-Permeable
Salicylamide 	Permeable
Salicylic acid 	Non-Permeable
Salmeterol 	Permeable
Salsalate 	Permeable
Samarium (153Sm) lexidronam 	Non-Permeable
Samidorphan 	Non-Permeable
Sapropterin 	Non-Permeable
Saquinavir 	Non-Permeable
Sarecycline 	Non-Permeable
Saxagliptin 	Non-Permeable
Scopolamine 	Permeable
Secnidazole 	Permeable
Secobarbital 	Permeable
Segesterone acetate 	Permeable
Selegiline 	Permeable
Selenic acid 	Permeable
Selenious acid 	Permeable
Selenium 	Permeable
Selenium Sulfide 	Permeable
Selenomethionine 	Permeable
Selenomethionine Se-75 	Permeable
Selexipag 	Non-Permeable
Selinexor 	Permeable
Selpercatinib 	Non-Permeable
Selumetinib 	Non-Permeable
Semaglutide 	Non-Permeable
Serdexmethylphenidate 	Non-Permeable
Sertaconazole 	Permeable
Sertindole 	Permeable
Sertraline 	Permeable
Setmelanotide 	Non-Permeable
Sevelamer 	Permeable
Sevoflurane 	Permeable
Sibutramine 	Permeable
Silanol 	Permeable
Sildenafil 	Non-Permeable
Silicon 	Permeable
Silicon dioxide 	Permeable
Silodosin 	Non-Permeable
Silver 	Permeable
Silver nitrate 	Permeable
Silver sulfadiazine 	Non-Permeable
Simeprevir 	Non-Permeable
Simethicone 	Permeable
Simvastatin 	Permeable
Sinapultide 	Non-Permeable
Sincalide 	Non-Permeable
Siponimod 	Permeable
Sirolimus 	Non-Permeable
Sitagliptin 	Permeable
Sitaxentan 	Permeable
"Sodium 1 	Permeable
Sodium acetate 	Non-Permeable
Sodium ascorbate 	Non-Permeable
Sodium bicarbonate 	Non-Permeable
Sodium bisulfite 	Non-Permeable
Sodium borate 	Permeable
Sodium camphorsulfonate 	Non-Permeable
Sodium carbonate 	Non-Permeable
Sodium chloride 	Invalid SMILES
Sodium chromate Cr-51 	Permeable
Sodium citrate 	Non-Permeable
Sodium feredetate 	Non-Permeable
Sodium ferric gluconate complex 	Non-Permeable
Sodium fluoride 	Invalid SMILES
Sodium fluorophosphate 	Permeable
Sodium glycerophosphate 	Permeable
Sodium hydroxide 	Invalid SMILES
Sodium iodide 	Invalid SMILES
Sodium lauryl sulfoacetate 	Permeable
Sodium metavanadate 	Permeable
Sodium molybdate 	Permeable
Sodium oxybate 	Non-Permeable
Sodium phosphate P 32 	Non-Permeable
"Sodium phosphate 	Permeable
Sodium stibogluconate 	Non-Permeable
Sodium sulfate 	Permeable
Sodium sulfide 	Invalid SMILES
Sodium tartrate 	Non-Permeable
Sodium tetradecyl sulfate 	Permeable
Sodium zirconium cyclosilicate 	Permeable
Sofosbuvir 	Non-Permeable
Solifenacin 	Permeable
Solriamfetol 	Permeable
Somatostatin 	Non-Permeable
Sonidegib 	Permeable
Sorafenib 	Non-Permeable
Sorbitol 	Non-Permeable
Sotagliflozin 	Permeable
Sotalol 	Permeable
Sotorasib 	Non-Permeable
Sparfloxacin 	Non-Permeable
Spectinomycin 	Non-Permeable
Spinosad 	Non-Permeable
Spiramycin 	Non-Permeable
Spirapril 	Permeable
Spironolactone 	Non-Permeable
Squalene 	Permeable
Stannous chloride 	Invalid SMILES
Stannous fluoride 	Permeable
Stanozolol 	Non-Permeable
Stavudine 	Non-Permeable
Stearic acid 	Permeable
Steviolbioside 	Non-Permeable
Stiripentol 	Permeable
Streptomycin 	Non-Permeable
Streptozocin 	Non-Permeable
Strontium chloride 	Invalid SMILES
Strontium chloride Sr-89 	Invalid SMILES
Strontium ranelate 	Non-Permeable
Succimer 	Non-Permeable
Succinic acid 	Non-Permeable
Succinylcholine 	Non-Permeable
Sucrose 	Non-Permeable
Sufentanil 	Permeable
Sugammadex 	Non-Permeable
Sulbactam 	Non-Permeable
Sulconazole 	Permeable
Sulfabenzamide 	Permeable
Sulfacetamide 	Permeable
Sulfacytine 	Permeable
Sulfadiazine 	Permeable
Sulfadimethoxine 	Permeable
Sulfadoxine 	Permeable
Sulfamerazine 	Permeable
Sulfameter 	Non-Permeable
Sulfamethazine 	Permeable
Sulfamethizole 	Permeable
Sulfamethoxazole 	Permeable
Sulfametopyrazine 	Permeable
Sulfanilamide 	Permeable
Sulfaphenazole 	Permeable
Sulfapyridine 	Permeable
Sulfasalazine 	Permeable
Sulfathiazole 	Permeable
Sulfinpyrazone 	Permeable
Sulfisoxazole 	Permeable
Sulfoxone 	Non-Permeable
Sulfur hexafluoride 	Permeable
Sulindac 	Permeable
Sulpiride 	Permeable
Sultamicillin 	Non-Permeable
Sulthiame 	Permeable
Sultopride 	Permeable
Sumatriptan 	Non-Permeable
Sunitinib 	Non-Permeable
Suprofen 	Non-Permeable
Suvorexant 	Permeable
Synthetic camphor 	Permeable
Tacrine 	Permeable
Tacrolimus 	Non-Permeable
Tadalafil 	Permeable
Tafamidis 	Permeable
Tafenoquine 	Permeable
Tafluprost 	Permeable
Talazoparib 	Permeable
Talbutal 	Permeable
Talc 	Invalid SMILES
Tamoxifen 	Permeable
Tamsulosin 	Permeable
Tannic acid 	Non-Permeable
Tapentadol 	Non-Permeable
Tapinarof 	Non-Permeable
Tasimelteon 	Permeable
Taurine 	Non-Permeable
Taurocholic acid 	Non-Permeable
Taurolidine 	Permeable
Tauroursodeoxycholic acid 	Permeable
Tavaborole 	Permeable
Tazarotene 	Permeable
Tazemetostat 	Non-Permeable
Tazobactam 	Non-Permeable
Technetium Tc-99m disofenin 	Non-Permeable
Technetium Tc-99m etidronate 	Non-Permeable
Technetium Tc-99m mebrofenin 	Non-Permeable
Technetium Tc-99m medronate 	Non-Permeable
Technetium Tc-99m oxidronate 	Non-Permeable
Technetium Tc-99m pertechnetate 	Invalid SMILES
Technetium Tc-99m pyrophosphate 	Permeable
Technetium Tc-99m sestamibi 	Permeable
Technetium Tc-99m succimer 	Non-Permeable
Technetium Tc-99m sulfur colloid 	Permeable
Technetium Tc-99m tetrofosmin 	Permeable
Tecovirimat 	Permeable
Tedizolid 	Permeable
Tedizolid phosphate 	Permeable
Tegafur 	Permeable
Tegafur-uracil 	Permeable
Tegaserod 	Non-Permeable
Teicoplanin 	Non-Permeable
Telaprevir 	Non-Permeable
Telavancin 	Non-Permeable
Telbivudine 	Permeable
Telithromycin 	Non-Permeable
Telmisartan 	Permeable
Telotristat ethyl 	Non-Permeable
Temazepam 	Permeable
Temocillin 	Non-Permeable
Temoporfin 	Non-Permeable
Temozolomide 	Non-Permeable
Temsirolimus 	Non-Permeable
Tenapanor 	Non-Permeable
Teniposide 	Non-Permeable
Tenofovir alafenamide 	Non-Permeable
Tenofovir disoproxil 	Permeable
Tenoxicam 	Non-Permeable
Tepotinib 	Non-Permeable
Terazosin 	Permeable
Terbinafine 	Non-Permeable
Terbutaline 	Permeable
Terconazole 	Non-Permeable
Terfenadine 	Non-Permeable
Teriflunomide 	Permeable
Terizidone 	Non-Permeable
Terpin hydrate 	Permeable
Testolactone 	Non-Permeable
Testosterone 	Non-Permeable
Testosterone cypionate 	Permeable
Testosterone enantate benzilic acid hydrazone 	Non-Permeable
Testosterone enanthate 	Permeable
Testosterone propionate 	Permeable
Testosterone undecanoate 	Permeable
Tetrabenazine 	Permeable
Tetracaine 	Permeable
Tetrachlorodecaoxide 	Permeable
Tetracosactide 	Non-Permeable
Tetracycline 	Non-Permeable
Tetracycline phosphate complex 	Non-Permeable
Tetradecyl hydrogen sulfate (ester) 	Permeable
Tetraferric tricitrate decahydrate 	Permeable
Tetrakis(2-methoxyisobutylisocyanide)copper(I) tetrafluoroborate 	Permeable
Tetramethylthiuram monosulfide 	Permeable
Tetrofosmin 	Permeable
Tetryzoline 	Permeable
Tezacaftor 	Non-Permeable
Thalidomide 	Permeable
Thallous chloride 	Invalid SMILES
Thallous chloride Tl-201 	Permeable
Thenalidine 	Permeable
Thenyldiamine 	Permeable
Theophylline 	Non-Permeable
Thiabendazole 	Permeable
Thiamine 	Permeable
Thiamylal 	Permeable
Thiethylperazine 	Permeable
Thimerosal 	Permeable
Thiohexam 	Permeable
Thiopental 	Non-Permeable
Thioridazine 	Permeable
Thiosulfuric acid 	Permeable
Thiotepa 	Permeable
Thiothixene 	Permeable
Thiram 	Permeable
Thonzonium 	Permeable
Thonzylamine 	Permeable
Threonine 	Permeable
Thymol 	Permeable
Tiagabine 	Permeable
Tiaprofenic acid 	Permeable
Tibolone 	Permeable
Ticagrelor 	Non-Permeable
Ticarcillin 	Non-Permeable
Ticlopidine 	Permeable
Tigecycline 	Non-Permeable
Tilarginine 	Non-Permeable
Tilbroquinol 	Non-Permeable
Tiludronic acid 	Non-Permeable
Timolol 	Permeable
Tinidazole 	Permeable
Tioconazole 	Permeable
Tioguanine 	Non-Permeable
Tiopronin 	Permeable
Tiotropium 	Non-Permeable
Tipiracil 	Non-Permeable
Tipranavir 	Non-Permeable
Tirbanibulin 	Permeable
Tirofiban 	Permeable
Titanium dioxide 	Permeable
Tivozanib 	Permeable
Tixocortol 	Permeable
Tizanidine 	Permeable
Tobramycin 	Non-Permeable
Tocainide 	Permeable
Tofacitinib 	Permeable
Tolazamide 	Non-Permeable
Tolazoline 	Permeable
Tolbutamide 	Non-Permeable
Tolcapone 	Non-Permeable
Tolfenamic acid 	Permeable
Tolmetin 	Permeable
Tolnaftate 	Permeable
Tolterodine 	Permeable
Tolvaptan 	Permeable
Topiramate 	Permeable
Topotecan 	Non-Permeable
Torasemide 	Permeable
Toremifene 	Permeable
Trabectedin 	Non-Permeable
Tramadol 	Permeable
Trametinib 	Non-Permeable
Trandolapril 	Permeable
Tranexamic acid 	Non-Permeable
Tranylcypromine 	Permeable
Travoprost 	Permeable
Trazodone 	Permeable
Treosulfan 	Permeable
Treprostinil 	Permeable
Tretinoin 	Permeable
Triamcinolone 	Permeable
Triamterene 	Non-Permeable
Triazolam 	Permeable
Trichlormethiazide 	Non-Permeable
Trichloroethylene 	Permeable
Triclabendazole 	Permeable
Triclocarban 	Permeable
Triclofos 	Permeable
Triclosan 	Permeable
Triethylenetetramine 	Permeable
Trifarotene 	Non-Permeable
Trifluoperazine 	Permeable
Triflupromazine 	Permeable
Trifluridine 	Non-Permeable
Triflusal 	Permeable
Triheptanoin 	Permeable
Trihexyphenidyl 	Permeable
Trilaciclib 	Non-Permeable
Trilostane 	Non-Permeable
Trimebutine 	Permeable
Trimetazidine 	Permeable
Trimethadione 	Permeable
Trimethaphan 	Permeable
Trimethobenzamide 	Permeable
Trimethoprim 	Permeable
Trimetrexate 	Non-Permeable
Trimipramine 	Permeable
Trioxsalen 	Permeable
Tripelennamine 	Permeable
Triprolidine 	Permeable
Triptorelin 	Non-Permeable
Tritoqualine 	Permeable
Troglitazone 	Non-Permeable
Trolamine 	Non-Permeable
Trolamine salicylate 	Non-Permeable
Troleandomycin 	Non-Permeable
Tromantadine 	Permeable
Tromethamine 	Non-Permeable
Tropicamide 	Permeable
Tropisetron 	Permeable
Trospium 	Non-Permeable
Trovafloxacin 	Permeable
Trypan blue free acid 	Non-Permeable
Tryptophan 	Permeable
Tubocurarine 	Non-Permeable
Tucatinib 	Non-Permeable
Tyropanoic acid 	Permeable
Tyrosine 	Permeable
Ubidecarenone 	Non-Permeable
Ubiquinol 	Non-Permeable
Ubrogepant 	Permeable
Udenafil 	Non-Permeable
Ulipristal 	Non-Permeable
Ulobetasol 	Permeable
Umbralisib 	Non-Permeable
Umeclidinium 	Permeable
Undecoylium chloride iodine complex 	Permeable
Undecylenic acid 	Permeable
Unoprostone 	Permeable
Upadacitinib 	Permeable
Uracil mustard 	Permeable
Urea 	Permeable
Urea C-13 	Permeable
Urea C-14 	Permeable
Urethane 	Permeable
Uridine triacetate 	Permeable
Ursodeoxycholic acid 	Non-Permeable
Vaborbactam 	Permeable
Valaciclovir 	Permeable
Valbenazine 	Permeable
Valdecoxib 	Non-Permeable
Valganciclovir 	Permeable
Valine 	Non-Permeable
Valproate bismuth 	Permeable
Valproic acid 	Permeable
Valrubicin 	Non-Permeable
Valsartan 	Permeable
Vanadium 	Permeable
Vancomycin 	Non-Permeable
Vandetanib 	Non-Permeable
Vanillyl butyl ether 	Permeable
Vardenafil 	Non-Permeable
Varenicline 	Permeable
Vasopressin 	Non-Permeable
Vecuronium 	Non-Permeable
Velpatasvir 	Non-Permeable
Vemurafenib 	Permeable
Venetoclax 	Non-Permeable
Venlafaxine 	Permeable
Verapamil 	Non-Permeable
Vericiguat 	Permeable
Vernakalant 	Permeable
Verteporfin 	Non-Permeable
Vibegron 	Non-Permeable
Vidarabine 	Permeable
Vigabatrin 	Permeable
Vilanterol 	Permeable
Vilazodone 	Permeable
Vildagliptin 	Permeable
Viloxazine 	Permeable
Vinblastine 	Non-Permeable
Vincristine 	Non-Permeable
Vindesine 	Non-Permeable
Vinflunine 	Non-Permeable
Vinorelbine 	Permeable
Viomycin 	Non-Permeable
Vismodegib 	Non-Permeable
Vitamin A 	Permeable
Vitamin E 	Permeable
Voclosporin 	Non-Permeable
Vonoprazan 	Permeable
Vorapaxar 	Permeable
Voriconazole 	Permeable
Vorinostat 	Permeable
Vortioxetine 	Permeable
Voxelotor 	Permeable
Voxilaprevir 	Non-Permeable
Warfarin 	Non-Permeable
Xamoterol 	Permeable
Xanthinol 	Permeable
Xenon Xe-127 	Permeable
Xenon Xe-129 	Permeable
Xenon-133 	Permeable
Ximelagatran 	Non-Permeable
Xylometazoline 	Permeable
Xylose 	Non-Permeable
Yohimbine 	Non-Permeable
Yttrium Y-90 	Permeable
Zafirlukast 	Non-Permeable
Zalcitabine 	Permeable
Zaleplon 	Permeable
Zanamivir 	Non-Permeable
Zanubrutinib 	Non-Permeable
Zeaxanthin 	Non-Permeable
Ziconotide 	Non-Permeable
Zidovudine 	Non-Permeable
Zileuton 	Permeable
Zimelidine 	Permeable
Zinc 	Permeable
Zinc acetate 	Permeable
Zinc ascorbate 	Non-Permeable
Zinc dibutyldithiocarbamate 	Permeable
Zinc gluconate 	Non-Permeable
Zinc oxide 	Permeable
Zinc phenolsulfonate 	Non-Permeable
Zinc sulfate 	Permeable
Ziprasidone 	Permeable
Zirconium chloride hydroxide 	Permeable
Zofenopril 	Permeable
"Zoledronate D 	Non-Permeable
Zoledronic acid 	Non-Permeable
Zolmitriptan 	Non-Permeable
Zolpidem 	Permeable
Zonisamide 	Permeable
Zopiclone 	Permeable
Zotepine 	Permeable
Zucapsaicin 	Permeable
Zuclopenthixol 	Permeable
Zytron 	Permeable
